NO ./images/komurokei.xpm
SO ./images/bluestone.xpm
WE ./images/colorstone.xpm
EA ./images/greystone.xpm

F 220,100,0
C 225,30,0

1111111111111111111111111
1000000000000000000000001
1011000000000000000000001
1001000000000000000000001
1111111110000001110000000
1000000000000001111111111
111101111111110100000001
111101111111110111000001
110000001101010100000001
100000000000000011000000
100000000000000011010100
110000010101010111110N01
111101111110101101110100
111111111111111111111111
